5 7
0 0
0 0 0 0 0
1 4 2 2 0
1 3 0 4 2
1 1 3 0 1
1 4 3 0 1
1 0 0 4 1
1 0 4 1 0